NO ./textures/mossy.xpm
SO ./textures/greystone.xpm
WE ./textures/redbrick.xpm
EA ./textures/colorstone.xpm

F 220,100,0
C 225,30,0

11111111
10001101
10001001
10000001
10000001
100E0001
10000001
11111111