NO textures/wolf.xpm
SO textures/bird.xpm
EA textures/lion.xpm
WE textures/fish.xpm

F 75,108,87
C 173,216,230

111111111111111111111111111
100000000011000000100000010
101100000111000000000000111
101100000000000000000100111
111111111011000001110000111
100000000011000001110111111
11110111111111011100000000111111
111101111111110111010000000000N1
11000000110101011100000100111111
100000000000000111000001001
100000000000000000000101001
110000011101000111110111001
111101111110101101111010001
111111111111111111111111111