NO textures/wolf.xpm
SO textures/bird.xpm
EA textures/lion.xpm
WE textures/fish.xpm

F 75,108,87
C 173,216,230

111111111111111111111111111
100000000011000000100000010
101100000111000000000000111
101100000000000000000100111
111111111011000001110000111
100000000011000001110111111
111101111111110111000000001
111101111111110111010000001
110000001101010111000001001
100000000000000111N00001001
100000000000000000000101001
110000011101000111110111001
111101111110101101111010001 1 0 0 1
111111111111111111111111111         1